10,10,
gggggggggg
g00000000g
g00000000g
g00g00000g
g00g00000g
gd0g000g0g
gg0000gg0g
ggg00m000g
gp!00ggggg
gggggggggg
