10,10,
gggggggggg
g0000000dg
g0000ggggg
ge0g00000g
gg0000000g
g0g000000g
g000g0000g
g00000g00g
gp00b0b0gg
gggggggggg
